" ...toute ces fleurs symboliques qui disent  Ce que les mots ne savent aussi bien exprimer... "
							Lord Byron

Aubepine			espoir
Azalee				amour timide
Bleuet				delicatesse
Bruyere				solitude
Camelia				constance, modestie
Camomille			energie dans l'adversiter
Chevrefeuille			liens d'amour
Chrysantheme blanc		verite
Chrysantheme jaune		amour meconnu
Clematite			amour filial, securite
Crocus				allegresse
Cyclamen			manque d'assurance
Dahlia				instabilite
Fuschia				gout
Genet				humilite
Geranium			reconfort
Giroflee			fidelite dans le malheur
Glaieul				force de caractere
Hortensia			froideur
Iris				message
Jacinthe			grace et douceur
Jasmin d'Espagne		sensualite
Jonquille			affection partagee
Laurier				chastete
Lavande				mefiance
Lilas mauve			amour naissant
Lis blanc			purete
Lotus				oubli, silence
Magnolia			dignite
Marguerite (grande)		gage de patience
Mimosa				sensibilite
Muguet				retour du bonheur
Myosotis			souvenir fidele
Narcisse			egoisme
OEillet d'inde			refus, jalousie
Oranger (fleur d')		virginiter
Orchidee			beaute
Paquerette			affection partagee, innocence
Perce-neige			consolation
Pervenche			amitie sincere
Pivoine				honte
Pois de senteur			plaisir durable
Primevere			affection tendre et sincere, jeunesse
Rose				amour et beaute
Rose blanche			je suis digne de vous
Rose de mai			precocite
Rose jaune			jalousie, infidelite, amour vacillant
Rose moussue			amour voluptueux
Rose rouge			amour
Rose tremiere			fecondite
Souci				desespoir
Tournesol			orgueil
Tulipe rouge			declaration d'amour
Tulipe jaune et panachee	amour
Veronique			fidelite en amour, offrande d'un coeur
Violette			modestie, fidelite
Zinnia				pensee pour les amis absents
